20123
11111121111111111111
11111211111111111111
21111111121211111111
12121111121111111112
21111111111111111211
11111111222111111111
11121111211111111112
11111111111112111111
11112111111111111111
11111211111111111111
11111211211111111111
11111111112111211111
11111111111111121112
11111111111112111112
11111111111111111111
11111111111111121211
11111211111111111111
11121111112111111111
11111111111121111121
11111111111111111111
